# Rime table
# coding: utf-8
#@/db_name	cn_en_mix_zrm2000
#@/db_type	tabledb
#@/rime_version	1.5.3
4S店	4Sdm
A4腰	A4yk
A4纸	A4vi
AAA级	AAAji
AA吧	AAba
AA制	AAvi
AB型	ABxy
AB型血	ABxyxt
AB血型	ABxtxy
AD钙奶	ADglnl
Android	Android
Android版	Androidbj
Android版本	Androidbjbf
Android端	Androiddr
ASCII码	ASCIIma
ATM机	ATMji
A班	Abj
A杯	Abz
A出口	Aiukb
A点	Adm
A栋	Ads
A股	Agu
A和B	AheB
A级	Aji
A卡	Aka
A壳	Ake
A口	Akb
A款	Akr
A楼	Alb
A面	Amm
A盘	Apj
A片	Apm
A屏	Apy
A区	Aqu
A塔	Ata
A型	Axy
A型号	Axyhk
A型血	Axyxt
A血型	Axtxy
A杖	Avh
A罩	Avk
A罩杯	Avkbz
A组	Azu
A座	Azo
Backspace键	Backspacejm
BB机	BBji
Beta版	Betabj
Beta版本	Betabjbf
Big胆	Bigdj
BOSS直聘	BOSSvipn
B班	Bbj
B杯	Bbz
B超	Bik
B出口	Biukb
B点	Bdm
B栋	Bds
B哥	Bge
B股	Bgu
B级	Bji
B壳	Bke
B口	Bkb
B款	Bkr
B淋巴细胞	Blnbaxibk
B楼	Blb
B面	Bmm
B盘	Bpj
B区	Bqu
B细胞	Bxibk
B型	Bxy
B型号	Bxyhk
B型血	Bxyxt
B血型	Bxtxy
B站	Bvj
B罩	Bvk
B罩杯	Bvkbz
B组	Bzu
B座	Bzo
CapsLock键	CapsLockjm
Caps键	Capsjm
Chrome系	Chromexi
Chromium系	Chromiumxi
Cinity厅	Cinityty
Cmd键	Cmdjm
Command键	Commandjm
Control键	Controljm
Ctrl键	Ctrljm
CT检查	CTjmia
C班	Cbj
C杯	Cbz
C出口	Ciukb
C栋	Cds
C级	Cji
C壳	Cke
C口	Ckb
C款	Ckr
C楼	Clb
C罗	Clo
C面	Cmm
C盘	Cpj
C区	Cqu
C型	Cxy
C型号	Cxyhk
C语言	Cyuyj
C罩	Cvk
C罩杯	Cvkbz
C组	Czu
C座	Czo
DDoS攻击	DDoSgsji
Delete键	Deletejm
Del键	Deljm
DJ版	DJbj
DJ舞曲	DJwuqu
DNA检测	DNAjmce
DNS劫持	DNSjxii
DNS污染	DNSwurj
Dock栏	Docklj
DoS攻击	DoSgsji
DVD版	DVDbj
D班	Dbj
D杯	Dbz
D出口	Diukb
D栋	Dds
D级	Dji
D壳	Dke
D口	Dkb
D款	Dkr
D楼	Dlb
D面	Dmm
D盘	Dpj
D区	Dqu
D型	Dxy
D型号	Dxyhk
D罩	Dvk
D罩杯	Dvkbz
D之国	Dvigo
D之一族	Dviyizu
D组	Dzu
D座	Dzo
Eject键	Ejectjm
Enter键	Enterjm
Esc键	Escjm
Eul的神圣法杖	Euldeufugfavh
E杯	Ebz
E出口	Eiukb
E栋	Eds
E口	Ekb
E款	Ekr
E楼	Elb
E盘	Epj
E区	Equ
E型	Exy
E型号	Exyhk
e招贷	evkdl
E罩	Evk
E罩杯	Evkbz
E组	Ezu
E座	Ezo
Fn键	Fnjm
F杯	Fbz
F出口	Fiukb
F栋	Fds
F口	Fkb
F款	Fkr
F楼	Flb
F盘	Fpj
F区	Fqu
F型	Fxy
F型号	Fxyhk
F罩	Fvk
F罩杯	Fvkbz
F组	Fzu
F座	Fzo
Go程	Goig
Go圣经	Gougjy
Go语言	Goyuyj
G杯	Gbz
G点	Gdm
G盘	Gpj
G胖	Gph
G罩	Gvk
G罩杯	Gvkbz
H版	Hbj
H杯	Hbz
H股	Hgu
H罩	Hvk
H罩杯	Hvkbz
ICP备案	ICPbzan
IE浏览器	IElqljqi
iOS版	iOSbj
iOS版本	iOSbjbf
iOS端	iOSdr
IP地址	IPdivi
IP电话	IPdmhw
IP卡	IPka
IT界	ITjx
IT行业	IThhye
IT业	ITye
J·K·罗琳	JKloln
J·R·R·托尔金	JRRtoerjn
J盘	Jpj
K宝	Kbk
K粉	Kff
K歌	Kge
K歌王	Kgewh
K线	Kxm
K线图	Kxmtu
Lite版	Litebj
Lite版本	Litebjbf
L码	Lma
macOS版	macOSbj
macOS版本	macOSbjbf
macOS端	macOSdr
Mac版	Macbj
Mac版本	Macbjbf
MAC地址	MACdivi
Mac端	Macdr
M码	Mma
M系列	Mxilx
N遍	Nbm
N次	Nci
n次方	ncifh
N多	Ndo
N多个	Ndoge
N多人	Ndorf
N股	Ngu
N卡	Nka
N年	Nnm
OK啊	OKaa
OK不	OKbu
OK啦	OKla
OK了	OKle
OK了吗	OKlema
OK吗	OKma
OK嘛	OKma
OK么	OKme
OK呀	OKya
Option键	Optionjm
Opt键	Optjm
O不OK	ObuOK
O型	Oxy
O型血	Oxyxt
O血型	Oxtxy
Papi酱	Papijd
PC版	PCbj
PC版本	PCbjbf
PC端	PCdr
PIN码	PINma
PK赛	PKsl
POS机	POSji
Pro版	Probj
Pro版本	Probjbf
PUK码	PUKma
PVC管	PVCgr
P个图	Pgetu
P社	Pue
P图	Ptu
P一下	Pyixw
P站	Pvj
QQ飞车	QQfzie
QQ好友	QQhkyb
QQ号	QQhk
QQ号码	QQhkma
QQ会员	QQhvyr
QQ空间	QQksjm
QQ拼音	QQpnyn
QQ群	QQqp
QQ三国	QQsjgo
QQ输入法	QQuurufa
QQ堂	QQth
QQ秀	QQxq
QQ音乐	QQynyt
QQ音速	QQynsu
QQ邮箱	QQybxd
QQ游戏	QQybxi
QQ游戏大厅	QQybxidaty
Q版	Qbj
Q币	Qbi
Q弹	Qtj
Q我	Qwo
Return键	Returnjm
R级	Rji
Server酱	Serverjd
Shift键	Shiftjm
SIM卡	SIMka
Space键	Spacejm
Steam云	Steamyp
Switch版	Switchbj
Switch版本	Switchbjbf
S股	Sgu
S级	Sji
S码	Sma
S曲线	Squxm
S形	Sxy
Tab键	Tabjm
Telegram群	Telegramqp
TF版	TFbj
TF版本	TFbjbf
TF卡	TFka
TG群	TGqp
TV版	TVbj
TV版本	TVbjbf
T淋巴细胞	Tlnbaxibk
T台	Ttl
T细胞	Txibk
T型台	Txytl
T恤	Txu
T恤衫	Txuuj
UIM卡	UIMka
Up主	Upvu
USB接口	USBjxkb
USB口	USBkb
USB线	USBxm
USIM卡	USIMka
UU加速器	UUjwsuqi
U盾	Udp
U盘	Upj
U形	Uxy
U形管	Uxygr
U型锁	Uxyso
VIP卡	VIPka
VIP中P	VIPvsP
V怪客	Vgyke
V领	Vly
V煞	Vua
V社	Vue
V站	Vvj
V字仇杀队	Vziibuadv
V字领	Vzily
V字形	Vzixy
Web版	Webbj
Web版本	Webbjbf
Web端	Webdr
Web开发	Webklfa
Wi-Fi密码	WiFimima
Windows版	Windowsbj
Windows版本	Windowsbjbf
Windows端	Windowsdr
Win版	Winbj
Win版本	Winbjbf
Win端	Windr
X档案	Xdhan
X刀	Xdk
X光	Xgd
X光片	Xgdpm
X和Y	XheY
X教授	Xjcub
X染色体	Xrjseti
X射线	Xuexm
X战警	Xvjjy
X轴	Xvb
YY语音	YYyuyn
Y染色体	Yrjseti
Y轴	Yvb
z变换	zbmhr
z逆变换	znibmhr
Z轴	Zvb
阿Q	aaQ
阿Q精神	aaQjyuf
阿Q正传	aaQvgvr
阿Sir	aaSir
艾AA	aiAA
芭比Q	babiQ
芭比Q了	babiQle
波特卡斯·D·艾斯	botekasiDaisi
不OK	buOK
查bug	iabug
查IP	iaIP
唱K	ihK
炒CP	ikCP
充Q币	isQbi
大V	daV
单边z变换	djbmzbmhr
第N次	diNci
逗B	dbB
多边兽Z	dobmubZ
哆啦A梦	dolaAmg
二B	erB
发EMS	faEMS
丰田AE86	fgtmAE86
封IP	fgIP
改bug	glbug
哥尔·D·罗杰	geerDlojx
公网IP	gswhIP
关底BOSS	grdiBOSS
喊cut	hjcut
很OK	hfOK
红Buff	hsBuff
互fo	hufo
换IP	hrIP
加Q	jwQ
加QQ	jwQQ
减CD	jmCD
江南Style	jdnjStyle
就OK	jqOK
卡bug	kabug
卡拉OK	kalaOK
开party	klparty
嗑CP	keCP
蓝Buff	ljBuff
老Baby	lkBaby
老K	lkK
立Flag	liFlag
马歇尔·D·蒂奇	maxxerDdiqi
芒果TV	mhgoTV
没bug	mzbug
没有bug	mzybbug
蒙奇·D·卡普	mgqiDkapu
蒙奇·D·龙	mgqiDls
蒙奇·D·路飞	mgqiDlufz
谜拟Q	miniQ
牛B	nqB
拍CT	plCT
平A	pyA
乔治·R·R·马丁	qcviRRmady
圈X	qrX
日K线	riKxm
三K党	sjKdh
三无Marblue	sjwuMarblue
啥bug	uabug
傻B	uaB
傻X	uaX
随身Wi-Fi	svufWiFi
特拉法尔加·D·瓦铁尔·罗	telafaerjwDwatxerlo
腾讯QQ	tgxpQQ
藤子·F·不二雄	tgziFbuerxs
提bug	tibug
头文字D	tbwfziD
维A	wzA
维B	wzB
维C	wzC
维D	wzD
维E	wzE
维E乳	wzEru
维K	wzK
维生素A	wzugsuA
维生素B	wzugsuB
维生素C	wzugsuC
维生素D	wzugsuD
维生素E	wzugsuE
维生素E乳	wzugsuEru
维生素K	wzugsuK
我OK啊	woOKaa
我叫MT	wojcMT
小Baby	xcBaby
写bug	xxbug
异维A酸	yiwzAsr
有bug	ybbug
月K线	ytKxm
找bug	vkbug
智能ABC	vingABC
智能ABC输入法	vingABCuurufa
智能ABC双拼	vingABCudpn
智能ABC双拼方案	vingABCudpnfhan
周K线	vbKxm
周刊少年Jump	vbkjuknmJump
装B	vdB
做B超	zoBik
digimonx	digimonx
digimonx@qq.com	digimonx
worphi	worphi
worphi@foxmail.com	worphi
